1, 1, 1, 1, 1, 1, 1, 1, 1, 1, 1, 1, 1, 1, 1, 1, 1, 1
1, s, 0, 0, 0, 0, 1, 0, 0, 0, 0, 0, 0, 1, 0, 0, 0, 1
1, 0, 1, 0, 1, 0, 1, 0, 1, 0, 1, 1, 0, 0, 0, 1, 0, 1
1, 0, 1, 0, 1, 1, 1, 0, 1, 0, 0, 0, 1, 1, 1, 0, 0, 1
1, 0, 0, 1, 0, 0, 0, i, 0, 1, 1, 0, 1, 0, 1, d, 1, 1
1, 1, 0, 0, 1, 0, 1, 1, 1, 0, 0, 0, 2, 2, 1, 0, e, 1
1, 0, 0, 1, 1, 0, 1, 0, 0, 1, 0, 1, 0, 1, 1, 1, 1, 1
1, 0, 1, 0, 0, 0, 1, 1, 0, 1, 0, 0, 0, 0, 0, 0, 0, 1
1, 0, 0, 0, 1, 0, b, 0, 0, 1, 0, 1, 1, 1, 1, 0, 1, 1
1, 1, 0, 1, 1, 0, 1, 0, 1, 0, 1, 0, 0, 0, 1, 0, 0, 1 
1, 0, 0, 1, 0, 0, 1, 0, 1, 0, 1, 0, 1, 0, 0, 1, 0, 1
1, 0, 1, 1, 0, 1, 0, 0, 0, 0, 0, 0, 1, 1, 0, 1, c, 1
1, 0, 1, 0, 0, 1, 0, 1, 0, 1, 1, 1, 0, 0, 0, 1, 0, 1
1, 0, 0, 1, 0, 0, f, 0, 0, 1, 0, 0, 0, 1, 1, 3, 0, 1
1, 1, 0, 1, 1, 1, 0, 1, 0, 1, 0, 1, g, 1, 1, 0, 1, 1
1, a, 0, 1, 0, 0, 0, 4, 4, 0, 0, h, 0, 0, 0, 0, 0, 1
1, 1, 1, 1, 1, 1, 1, 1, 1, 1, 1, 1, 1, 1, 1, 1, 1, 1