1, 1, 1, 1, 1, 1, 1, 1, 1, 1, 1, 1, 1, 1, 1, 1, 1, 1
1, s, 0, 0, 0, 0, 1, 0, 0, 0, 0, 0, 0, 1, 0, 0, 0, 1
1, 0, 1, 0, 1, 0, 1, 0, 1, 0, 1, 1, 0, 0, 0, 1, 0, 1
1, 0, 1, 0, 1, 1, 1, 0, 1, 0, 0, 0, 1, 1, 1, 0, 0, 1
1, 0, 0, 1, 0, 0, 0, g, 0, 1, 1, 0, 1, 0, 1, h, 1, 1
1, 1, 0, 0, 1, 0, 1, 1, 1, 0, 0, 0, 0, 0, 1, 0, e, 1
1, 0, 0, 1, 1, 0, 1, 0, c, 1, 0, 1, 0, 1, 1, 1, 1, 1
1, 0, 1, 0, 0, 0, 1, 1, 0, 1, 0, 0, 0, 0, 0, 0, 0, 1
1, 0, 0, 0, 1, 0, b, 0, 0, 1, 0, 1, 1, 1, 1, 0, 1, 1
1, 1, 0, 1, 1, 0, 1, 0, 1, 0, 1, 0, 0, 0, 1, 0, 0, 1 
1, 0, 0, 1, 0, 0, 1, 0, 1, 0, 1, 0, 1, 0, 0, 1, 0, 1
1, 0, 1, 1, 0, 1, 0, 1, 0, 0, 0, 0, 1, 1, 0, 1, 0, 1
1, 0, 1, 0, 0, 1, 0, 1, 0, 1, 1, 1, 0, 0, 0, 1, 0, 1
1, 0, 0, 1, 0, 0, d, 0, 0, 1, 0, 0, 0, 1, 1, 0, 0, 1
1, 1, 0, 1, 1, 1, 0, 1, 0, 1, 0, 1, 1, i, 1, 0, 1, 1
1, a, 0, 1, 0, 0, 0, 0, 0, 1, 0, f, 1, 0, 0, 0, 0, 1
1, 1, 1, 1, 1, 1, 1, 1, 1, 1, 1, 1, 1, 1, 1, 1, 1, 1